Surname	Name
Liu	Xiangping
Wescott	Danny
Alanis	Emanuel
Lewis	Karen
Chang	Carolyn
Summers	Lucia
Resendiz	Maria
Tesic	Jelena
Lakomski	Gregory
Au	Chiu
Ojeda-Ruiz	Ivan
Lee	Young Ju
Lee	Chul-Ho
Bhandari	Keshav
Metsis	Vangelis
Farias	Mylene
Zong	Ziliang
Qasem	Apan
Kim	Hyunhwan
Zhu	Jie
Yuan	Yihong
Hewitt	Barbara
Cho	Eunsang
Wang	Feng
Ozbakkaloglu	Togay
Aslan	Semih
Valles	Damian
Dong	Wenquan
Jin	Tongdan
Adi	Nadim
Mendez	Francis
Ekin	Tahir
Musal	Rasim
Konur	Dincer
Zhu	Emily
Shen	Xiaoxi
Hughes	Monica
Lewis	Holly
Gobert	Denise
Williams	Shannon
Das	Subasish
Bauld	Sean
Perez	Eduardo
Schepis	Ty
Price	Larry
Nason	Erica
Royal	Cindy
Gibbs	David
Dolozel	Diane
Fritts	Sarah
Chow	Edwin
Feng	Li
Shen	Vishan
Veselka	Holly
Watt	Toni